1111111111
1110101101
0010101101
1110101101
1111101101
1000000000
1011101111
1010101111
1010101111
1110111111